-6 -3 1 0
00002222222222222222222222222222222222222222222222222222222222222222222222222222
00002111111111111111111111111111211111111111111111111111111111111111111111111111
00002111111111111111111111111111211111111111111111111111111111111111111111111111
00002111111111111111111111111111211111111111111111111111111111111111111111111111
00002111111111111111111111111111211111111111111111111111111111111111111111111111
00002000000000000000000000000000211111111111111111111111111111111111111111111111
00002000000000000000000000000000211111111111111111111111111111111111111111111111
00002000000000000000000000000000211111111111111111111111111111111111111111111111
00002000000000000000000000000000211111111111111111111111111111111111111111111111
00002000000000000000000000000000211111111111111111111111111111111111111111111111
00002000000000000000000000000000211x11111111111121111111111111111111111111111111
00002000000000000000000000000000211111111111111111111111111111111111111111111111
00002000000000000000000000000000211111111111111111111111211111111111111111111111
00002000000000000000000000000000211111111111111111111111111111111111111111111111
00002000000000000000000000000022222222222211111111111111111111111111111111111111
00002000000000000000000000000022222222222211111111111111211111111111111111111111
00002000000000000000000000000022222222222211111111111111111111111111111111111111
00002000000000000000000000000000222222221111111111111111111111111111111111111111
00002000000000000000000000000000222222221111111121111111211111111111111111111111
00002000000000000000000000000000222222221111111111111111111111111111111111111111
00002000000000000000000000000000222222221111111111111111111111111111111111111111
00002000000000000000000000000000222222221111111111111111111111111111111111111111
00002000000000000000000000000000222222221111111111111111111121111111111111111111
00002000000000000000000000000000222222221111111111111111111111111111111111111111
00002000000000000000000000000000222222221111111111111111111111111111111111111111
00002000000000000000000000000000222222221111111111111111111111111111111111111111
00002000000000000000000000000000222222221111111111111111111111111111111111111111
00002000000000000000000000000000222222221111111111222111111111111111111111111111
00002000000000000000000000000000222222221111111111222111111111111111111111111111
00002000000000000000000000000000222222221111111111222111111111111111111111111111
00002222222222222222222222222222222222222221111111111111111111111111111111111111
00000000000000000000000000000000000000000021111111111111111111111111111111111111
00000000000000000000000000000000000000000021111111111111111111111112222111111111
00000000000000000000000000000000000000000021111111111111111111111112222111111111
00002000000000000000000000000000000000011121111111111111111111111112222111111111
00002000000000000000000000000000000000011121111111111111111111111111111111111111
00002000000000000000000000000000000000011121111111111111111111111111111111111111
00002000000000000000000000000000000000011121111111111111111111111111111111111111
00002000000000000000000000000000000000011121111111111111111111111111111111111111
00002000000000000000000000000000000000011121111111111111111111111111111111111111
00002000000000000000000000000000000000011121111111111111111111111111111111111111
00002000000000000000000000000000000000011121111111111111111111111111111111111111
00002000000000000000000000000000000000011121111111111111111111111111111111111111
00002000000000000000000000000000000000011121111111111111111111111111111111111111
00002000000000000000000000000000000000022222222222222111111111111111111111111111
00002000000000000000000000000000000000021111111111111111111111111111111111111111
00002000000000000000000000000000000000021111111111111111111111111111111111111111
00002000000000000000000000000000000000021111111111111111111111111111111111222211
00002000000000000000000000000000000000021111111111111111111111111111111111222211
00002000000000000000000000000000000000021111111111111111111111111111112111222211
00002000000000000000000000000000000000021111111111111111111111111111112111111111
00002000000000000000000000000000000000021111111111111112222111111111112111111111
00002000000000000000000000000000000000021111111111111112222111111111112111111111
00002000000000000000000000000000000000021111111111111112222111111111112111111111
00002000000000000000000000000000000000021111111111111112222111111111112111111111
00002000000000000000000000000000000000021111111111111112222222222222222111111111
00002000000000000000000000000000000000021111111111111111111111111111112111111111
00002000000000000000000000000000000000021111111111111111111111111221112111111111
00002000000000000000000000000000000000021111111111111111111111111221112222222222
00002000000000000000000000000000000000021111111111111111111111111111112111111111
00002000000000000000000000000000000000021111111111111111111111111111112111111111
00002000000000000000000000000000000000021111112221111111111111111111112111111111
00002000000000000000000000000000000000021111112221111111111111111111112111111111
00002000000000000000000000000000000000021111112221111111111111111111112111111111
00002000000000000000000000000000000000021111111111111111111111111111112111100000
00002000000000000000000000000000000000021111111111111111111111111111112111100000
00002000000000000000000000000000000000021111111111111111111111111111111111100000
00002000000000000000000000000000000000021111111111111111111111111111111111111111
00002000000000000000000000000000000000021111111111111111111111111111111111111111
00002222222222222222222222222222222222222222222222222222222222222222222222222221
