00044040
00111114
11111114
1x111110
11111110
11111030
04434000
