-7 -12
0004322111111131000
0113111111111113000
0111111111111x00300
0111111111111111400
0111111111111111400
0111111111111111400
0111111111111111400
0111111111111111400
0111111111111111400
0111111111111111400
0111111111111111140
0111111111111111140
0111144421111111140
0111130001111111140
0111000001111111140
0003000001111111110
0000000001111101110
0000000001111111110
