-106 -39 4 0
98765432109876543210987654321098765432101234567890123456789012345678901234567890123456
00000000000000000000000000000000000000000000044400000000000000000000000000000000000000
00000000000000000000000000000000000000244442411140000000000000000000000000000000000000
00000000000000444444244400000040033324211114111110323233443000000000000000000000000000
00000000000000111114411100011114111121111114111111111111112224000000000000000000000000
00000000000000111111111110001111111111111114111111111111111111400000000000000000000000
00000000000000111111111120001111111111111114111111111111111111440000000000000000000000
00000000000000111111111110011111111111111114111111111111111111222000000000000000000000
00000000000000111111111100001111111111111114111111111111111111214440000000000000000000
00000000000000111111111000001111111111111114111111111111111111111144000000000000000000
00000000000000111111111021201111111111111114111111111111111111111111400000000000000000
00000000000000111111111111211111111111111114111111111111111111111111400000000000000000
00000000000000111111111111111111111111111111111111111111111111111111400000000000000000
00000000000000111111111111111111111111111111111111111111111111111111400000000000000000
00000000000000111111111111111110111111101001111111111111111111111111400000000000000000
00000000000000111111111111111111111233412111111111111111111111111111400000000000000000
00000000004444211111111111111111423004111111141111111111111111111111400000000000000000
00000000004411111111111111111111114004111111141111111111111111111111400000000000000000
00000000001111111121211111111111114004111111141111111111111111111111400000000000000000
00000000001111111303111111111111114001111111141111111111111111111111400000000000000000
00000000001111111103111111111111111421111111141111111111111111111111400000000000000000
00000000001111111131111111111111111111111111141114111111111111111111400000000000000000
00000000001111111110111111111111111111111111141141111111111111111111400000000000000000
00000000001111111110111111111111111111111111141141111111111111111111400000000000000000
00000000001111111113111111111111111111111111142411111111111111111111400000000000000000
01111000001111111130111111111111111111111111140011111111111111111111400000000000000000
01111000001111121000111111111111111111111111144221112111101121212444243024442444440000
41111000001111111000111111111111111111111111141111112111211111111011111021111111114000
44111100001111111000111111111111111111111111141111111231211111111111111111111111111400
44111110001111111111111111111111111111111111141111111111111111111111111111111111111400
04111110001111111111111111111111111111111111141111111111111111111111111111111111111400
44111110001111111111111111111111111111111111141111111111111111111111111111111111114400
01111110001111111001111111111111111111111110331111111111111111111111111111113111111400
01111110001111111001111111111111111111111111111111111111111111111111111111111111114400
41111110001111111001111110212111111111111111111111111111111111111111111111111111111130
04111110001111111001111122103011111111111111111111111111111111111111111111111111111110
04111110001111111001111112233011111111111111111111111111111111111111111111111111111110
04111111111111111111111111111111111111111111111111111111111111111111111111111120111120
04111111111111111111111111111111111111111111111111111111111111111111111111111120222200
04111111111111111111111111111111111111111111111111111111111111111111111111111111121000
00000111001111111111111111111111111111111111122111111111111111111111111111111111111110
00000111001111111111112111111111111411230032004411144424444111111111111111111111111110
00004111001111211441112111211114442444200000004444000000000111111111111111111111111110
00000414002444244444440244224440000000000000000000000000000003311111111111111111111120
00000004000000000000000000000000000000000000000000000000000004211111111111111111111110
00000000000000000000000000000000000000000000000000000000000000111111111111111111111111
00000000000000000000000000000000000000000000000000000000000000111111111111111111111110
00000000000000000000000000000000000000000000000000000000000004111111111111111111111110
00000000000000000000000000000000000000000000000000000000000000311111111111111111111110
00000000000000000000000000000000000000000000000000000000000000111111111111111111111120
00000000000000000000000000000000000000000000000000000000000000111111111111111111111110
00000000000000000000000000000000000000000000000000000000000003111111111111111111111110
00000000000000000000000000000000000000000000000000000000000004111111111111111111111111
00000000000000000000000000000000000000000000000000000000000004311111111111111111111110
00000000000000000000000000000000000000000000000000000000000000111111111111111111111111
00000000000000000000000000000000000000000000000000000000000000111111111111111111111111
00000000000000000000000000000000000000000000000000000000000004111111111111111111111110
00000000000000000000000000000000000000000000000000000000000044411111111111111111111110
00000000000000000000000000000000000000000000000000000000000031111111111111111111111111
00000000000000000000000000000000000000000000000000000000000011111111111111111111111110
00000000000000000000000000000000000000000000000000000000000011111111111111111111111110
00000000000000000000000000000000000000000000000000000000000000311111111111111111111110
00000000000000000000000000000000000000000000000000000000000000411111111111111111111120
00000000000000000000000000000000000000000000000000000000000000111111111111111111111110
00000000000000000000000000000000000000000000000000000000000004111111111111111111111120
00000000000000000000000000000000000000000000000000000000000044111111111111111111111110
00000000000000000000000000000000000000000000000000000000000041111111111111111111111140
00000000000000000000000000000000000000000000000000000000000041111111111111111144111400
00000000000000000000000000000000000000000000000000000000000041111111111111111114222200
00000000000000000000000000000000000000000000000000000000000004411111111111111114004000
00000000000000000000000000000000000000000000000000000000000000551111111111111110000000
00000000000000000000000000000000000000000000000000000000000444111111211111111120000000
00000000000000000000000000000000000000000000000000000000004111111111244440034444000000
00000000000000000000000000000000000000000000000000000000004111111111403111141111400000
00000000000000000000000000000000000000000000000000000000004111111111201111111111400000
00000000000000000000000000000000000000000000000000000000004111111111131111111111400000
00000000000000000000000000000000000000000000000000000000001111111111111111111111400000
00000000000000000000000000000000000000000000000000000000041111111111112330111111400000
00000000000000000000000000000000000000000000000000000000001111111111113111111111400000
00000000000000000000000000000000000000000000000000000000001111111111111111111111400000
00000000000000000000000000000000000000111111111110000011211111111111111111111111400000
00000000000000000000000000001111111111111111111110000011111111111111111111112444000000
00000000000000000000000000001111111111111111111111000011111111111223111111110000000000
00000000000000000000000001111111111111111000001111111111111111111130111514440000000000
00000000000000000030000001111110000001111000001111111111111111111300355000100000000000
00000000000000000111300001111110000001111100031111111111111111111000000000000000000000
00000000000000000111110001110030003111111100003000000011111111111000000000000000000000
000000000000000041x1111111111100031111111130000000000011111111111000000000000000000000
00000000000000004111111111111100001111111100000000000011111111111000000000000000000000
00000000000000000555111111111140004111111000000000000011111111111000000000000000000000
00000000000000004001111004444400031111111400000000000011111111111000000000000000000000
00000000000000041111111100000000003044444000000000000011111111111000000000000000000000
00000000000000001111111100000000000000000000000000000411111111111000000000000000000000
00000000000000041111111140000000000000000000000000000411111111111000000000000000000000
00000000000000000111111400000000000000000000000000000411111111111000000000000000000000
00000000000000000111114000000000000000000000000000000411111111111000000000000000000000
00000000000000000311113000000000000000000000000000000411111111111000000000000000000000
00000000000000000031110000000000000000000000000000000011111111111000000000000000000000
00000000000000000000400000000000000000000000000000000011111111111000000000000000000000
00000000000000000000000000000000000000000000000000000011111111111000000000000000000000
00000000000000000000000000000000000000000000000000244411111111111100000000000000000000
00000000000000000000000000000000000000000000000244211111111111111000000000000000000000
00000000000000000000000000000000000000000000001114111111111111111000000000000000000000
00000000000000000000000000000000000000000000001111111111111111111000000000000000000000
00000000000000000000000000000000000000000012211111111111111111111000000000000000000000
00000000000000000000000000000000000000000011111111111111111111111000000000000000000000
00000000000000000000000000000000000000111111111111111111111111111000000000000000000000
00000000000000000000000000000000000000111111111111111111111111111000000000000000000000
00000000000000000000000000000000000000111111111111111111111111111000000000000000000000
00000000000000000000000000000000000000111111111111111111111111111000000000000000000000
00000000000000000000000000000000000000111111111111111111111111111000000000000000000000
00000000000000000000000000000000000000111111111111111111222011111000000000000000000000
00000000000000000000000000000000000000111111111111111111120011111300000000000000000000
00000000000000000000000000000000000000111111111111111111400011111000000000000000000000
00000000000000000000000000000000000000111111111111111120000011111000000000000000000000
00000000000000000000000000000000000000111111111111111130000023122000000000000000000000
00000000000000000000000000000000000000111111111111111110000000000000000000000000000000
00000000000000000000000000000000000000111111111111111111100000000000000000000000000000
00000000000000000000000000000000000000114111111111111111140000000000000000000000000000
00000000000000000000000000000000000000003011111111111111140000000000000000000000000000
00000000000000000000000000000000000000000011111111111111140000000000000000000000000000
00000000000000000000000000000000000000000011111111111111140000000000000000000000000000
00000000000000000000000000000000000000000040111111111111140000000000000000000000000000
00000000000000000000000000000000000000000000111111111111100000000000000000000000000000
00000000000000000000000000000000000000000000111111112111100000000000000000000000000000
00000000000000000000000000000000000000000004111111112120000000000000000000000000000000
00000000000000000000000000000000000000000000411111111000000000000000000000000000000000
00000000000000000000000000000000000000000001111111111000000000000000000000000000000000
00000000000000000000000000000000000000000000111111111200000000000000000000000000000000
00000000000000000000000000000000000000000000111111111000000000000000000000000000000000
00000000000000000000000000000000000000000000111421114000000000000000000000000000000000
00000000000000000000000000000000000000000000444024400000000000000000000000000000000000
