-31 -5 2 0
000000000000000011440000000000000000
000000000000000111124000000000000000
000000000000000111113000000000000000
000000000000000111112000000000000000
000000000000000111112005000000000000
000000000000000011112111500000000000
000000000000000011111111500000000000
000000000000000011111111000000000000
000000000000000011111111300000000000
000000000000000011111111130000000000
000000000000000011111111144400000000
000000000000000011111111211110000000
000000000000000011111111111112000000
000000000000000011111111111112000000
000000000000000011111111111113000000
000000000000000011111111111110000000
000000000000000011111111111113000000
000000000000000011111111111110000000
000000000000000011111111111144000000
000000000000000011111111111110000000
000000000000000011111111111110000000
000000000000000011111111111122300000
000000000000004411111111111121230000
000000000000444111111111111111113000
000000000000411111111111112111111303
000000000000111111111111112311111111
0000000000001111111111111110311111x1
000000000000111111111111130000111111
000000000220111111111111100000111144
000000002111111111111111140000211140
000011101111111111111111140000224000
000011111111111111111111140000000000
000011111111111111111111140000000000
000011111111111111111111330000000000
000011111111111111111111113000000000
000011111111111111111111112000000000
000011111111111111111111112000000000
000011111111111111111111130000000000
000011111111111111111111220000000000
000011111111111111111112200000000000
000011111111111111111111130000000000
000011111111111111111111140000000000
000011111111141111111111140000000000
000011113011141111111111140000000000
