-6 -3 1 0
00000000000000000000000000000000000000000000000000000000000000000000000000000000
00000000000000000000000000000000000000000000000000000000000000000000000000000000
00000000000000000000000000000000000000000000000000000000000000000000000000000000
00000000000000000000000000000000000000000000000000000000000000000000000000000000
00002222222222222222222222222222222222222222222222222222222222222000000000000000
00002000000000000000000000000000111111111111111111111111111111112000000000000000
00002000000000000000000000000000111111111111111111111111111111112000000000000000
00002000000000000000000000000000111111111111111111111111111111112000000000000000
00002000000000000000000000000000111111111111111111111111111111112000000000000000
00002000000000000000000000000000111111111111111122221111111111112000000000000000
00002000000000000000000000000000111x11111111111122221111111111112000000000000000
00002000000000000000000000000000111111111111111122221111111111112000000000000000
00002000000000000000000000000000111111111111111111111111111111112000000000000000
00002000000000000000000000000000111111111111111111111111111111112000000000000000
00002000000000000000000000000022222222222211111111111111111111112000000000000000
00002000000000000000000000000022222222222211111111111111111111112000000000000000
00002000000000000000000000000022222222222211111111111111111111112000000000000000
00002000000000000000000000000000000000011111111111111111111111112000000000000000
00002000000000000000000000000000000000011111111111111111111111112000000000000000
00002000000000000000000000000000000000011111111111111111111111112000000000000000
00002000000000000000000000000000000000011111111111111111111111112000000000000000
00002000000000000000000000000000000000011111111111111111111111112000000000000000
00002000000000000000000000000000000000011111111111111111111111112000000000000000
00002000000000000000000000000000000000011111111111111111111111112000000000000000
00002000000000000000000000000000000000011111111111111111111111112000000000000000
00002000000000000000000000000000000000011111111111111111111111112000000000000000
00002000000000000000000000000000000000011111111111111111111000002000000000000000
00002000000000000000000000000000000000011111111111111111111000002000000000000000
00002000000000000000000000000000000000011111111111111111111000002000000000000000
00002000000000000000000000000000000000011111111111111111111000002000000000000000
00002222222222222222222222222222222222222222222222222222222222222000000000000000
00000000000000000000000000000000000000000000000000000000000000000000000000000000
00000000000000000000000000000000000000000000000000000000000000000000000000000000
00000000000000000000000000000000000000000000000000000000000000000000000000000000
