0000000000000000000000000
0022222222222220000000000
0021111111111110000000000
0021111111111110000040000
0021111111111110001110000
0021111111111110001110000
0021111111111110001110000
0021111111111110001110000
0021111111111110001110000
0021111111111110001110000
0022222222211110001110000
0021111111111110001110000
0021111111111110001110000
0021111111111110001110000
0021111111111110001110000
0021111111111110001110000
0021111111111110001110000
0021111111111110001110000
0021111111111110001110000
0021111111111110001110000
0021111111111110001110000
0021111111111110001110000
0021111111111110001x10000
0021111111111110001110000
0021111111111110000040000
0021111111111110000000000
0021111111111110000000000
0021111111111110000000000
0022222222222220000000000
0000000000000000000000000
