-7 -12
000000000000000000
000000000000000000
000000000000000000
000002000000000000
001111111100000000
001111111100000000
001111111100000000
001111111100000000
001111111100000000
001111111100000000
001111111100000000
001111111100000000
001111111100000000
001111111100000000
001111111100000000
001111111100000000
001111111100000000
001111111100000000
001111111100000000
001111x11100000000
001111111100000000
001112000000000000
001110000000000000
001110000000000000
000000000000000000
